11111111111111111111111
11C0101001C000010111111
1E101C000101010000C1111
10100010100110011111111
1010C01010011010001C101
100011100010P0000100101
11011111011001C110011C1
110000010001001C0001101
1C01010C110110011100001
111101000100C0000001111
10C0010100010110010C001
11001010010101101110101
111110101C10101C0010101
10C0000C000010111010101
11111101100C10000010C01
1C100001001000011010001
11111111111111111111111